Key Table: Metec

Default Bindings
go left one window: LeftMiddle
go right one window: RightMiddle
go left one character: LeftRear+LeftFront
go right one character: RightRear+RightFront
go to beginning of line: LeftRear+LeftMiddle+LeftFront
go to end of line: RightRear+RightMiddle+RightFront
go up one line: RightRear
go down one line: RightFront
go to top line: LeftRear+RightRear
go to bottom line: LeftFront+RightFront
go to beginning of top line: LeftMiddle+RightRear
go to beginning of bottom line: LeftMiddle+RightFront
go up to nearest line with different content: RightMiddle+RightRear
go down to nearest line with different content: RightMiddle+RightFront
go up to nearest line with different highlighting: LeftMiddle+LeftRear
go down to nearest line with different highlighting: LeftMiddle+LeftFront
go up to previous command prompt: LeftMiddle+RightMiddle+LeftRear+RightRear
go down to next command prompt: LeftMiddle+RightMiddle+LeftFront+RightFront
go up to last line of previous paragraph: LeftMiddle+RightMiddle+RightRear
go down to first line of next paragraph: LeftMiddle+RightMiddle+RightFront
search backward for clipboard text: LeftMiddle+RightRear+RightFront+LeftRear
search forward for clipboard text: LeftMiddle+RightRear+RightFront+LeftFront
set cursor tracking on: LeftRear
set cursor tracking off: LeftFront
go back after cursor tracking: LeftRear+RightFront
go to cursor: LeftMiddle+RightRear+RightFront
go to current speech position: LeftRear+LeftFront+RightMiddle
bring cursor to line: LeftRear+LeftFront+RightRear+RightFront
enter/leave status display: LeftMiddle+RightMiddle
set display mode attributes/text: LeftRear+RightRear+RightMiddle
freeze/unfreeze screen image: LeftRear+LeftMiddle+RightRear
enter/leave help display: LeftRear+LeftMiddle+RightMiddle
enter/leave preferences menu: LeftRear+LeftFront+RightRear
insert clipboard text at cursor: LeftRear+LeftMiddle+LeftFront+RightRear
restore preferences from disk: LeftRear+LeftMiddle+LeftFront+RightMiddle
restart speech driver: LeftMiddle+LeftFront+RightRear
set attribute underlining on/off: LeftMiddle+LeftFront+RightRear+RightMiddle
save preferences to disk: LeftMiddle+RightRear+RightMiddle+RightFront
set text style 6-dot: LeftMiddle+LeftFront+RightMiddle
set text style 8-dot: LeftMiddle+LeftFront+RightFront
enter/leave command learn mode: LeftRear+RightRear+RightMiddle+RightFront
switch to next virtual terminal: LeftRear+LeftMiddle+LeftFront+RightFront
switch to previous virtual terminal: LeftFront+RightRear+RightMiddle+RightFront
stop speaking: LeftFront+RightRear
speak current line: LeftFront+RightMiddle
speak from top of screen through current line: LeftFront+RightMiddle+RightRear
speak from current line through bottom of screen: LeftFront+RightMiddle+RightFront
set autospeak on/off: LeftFront+RightRear+RightFront
bring cursor to character: RoutingKey1
start new clipboard at character: LeftRear+RoutingKey1
append to clipboard from character: LeftMiddle+RoutingKey1
linear copy to character: RightRear+RoutingKey1
rectangular copy to character: RightMiddle+RoutingKey1
describe character: LeftFront+RoutingKey1
place left end of window at character: RightFront+RoutingKey1
go up to nearest line with less indent than character: LeftMiddle+LeftRear+RoutingKey1
go down to nearest line with less indent than character: LeftMiddle+LeftFront+RoutingKey1
go up to nearest line with different character: RightMiddle+RightRear+RoutingKey1
go down to nearest line with different character: RightMiddle+RightFront+RoutingKey1
remember current window position: LeftRear+LeftFront+RoutingKey1
go to remembered window position: RightRear+RightFront+RoutingKey1
